######s#######
#...#....#...#
#.#.#.##.#.#.#
#.#......#.#.#
#...#....#.#.#
###.#.##.#.#.#
#...#....#.#.#
#.###..###.###
#.#......#...#
#.#.#.##.###.#
#.#.#......#.#
#.#.#..#####.#
#...#........#
######e#######
