####s#####
#....#...#
#.####.#.#
#.#....#.#
#.######.#
#.##...#.#
#.#..#...#
#.##.#.#.#
#......#.#
####e#####
