###s##
#....#
#...##
###.##
###e##
